........................................................
........................................................
.......0................................................
........................................................
....4.d.d.3.g........f...g.....g..........g..........g..
g..............f...g.............g....g......g.....g....
..g.4.d.d.3..g..........e.g...f.....e......g....f.......
........................................................
2.2.7.d.d.8.2.2.2.2.2.2.2.2.2.2.2.2.2.2.2.2.2.2.2.9.e.g.
........................................................
d.d.d.d.d.d.d.d.d.d.d.d.d.d.d.d.d.d.d.d.d.d.d.d.d.3..g..
................................................h.......
d.d.d.d.d.d.d.d.d.d.d.d.d.d.d.d.d.d.d.d.d.d.d.d.d.3.....
....................................................f...
1.1.1.1.1.1.1.1.1.1.1.1.1.1.1.1.1.1.1.1.1.1.1.1.1.b...g.
........................................................
........................................................
........................................................
........................................................
........................................................
