.......t..a.2.2.2.2.H.2.2.2.2.2.9...
....................................
r..G....t.4.o.k.k.k.i.k.k.k.k.n.3...
....................................
2.2.2.2.2.7.m.i.j.j.j.j.j.j.i.l.3.s.
....................................
k.k.k.k.k.kAi.l.6.u.h.h.h.f.m.l.3.t.
y.0.................................
j.j.j.j.j.j.j.p.3.4.o.k.k.k.i.l.3...
....................................
1.1.1.1.1.1.1.1.b.4.m.i.j.j.j.p.3...
.......r.............................
.E......a.2.2.H.2.7.m.l.6.1.1.1.b.t.
....................................
........4.o.k.i.k.k.i.l.3.t..r...t..
...........z........................
........4.q.j.j.j.j.j.p.3..t........
................................t...
.....s..c.1.1.1.1.1.1.1.b.....s.....
....................................
