a.2.2.2.2.2.2.2.2.2.2.2.2.2.2.2.2.2.9.
......................................
4.o.k.kMk.k.k.k.k.k.k.k.k.k.k.k.k.n.3.
...z..................................
4.q.j.j.I.i.j.j.i.i.j.j.J.i.j.j.i.l.3.
......................................
c.1.1.5.m.l.6.5.m.l.6.5.m.l.6.5.m.l.3.
t...............D...............C.....
......4.m.l.3.4.m.l.3.4.m.l.3.4.m.l.3.
..G.....C.......D.......D.......C.....
.s....4.m.l.3.4.m.l.3.4.m.l.3.4.m.l.3.
................D...............C.....
2.2.2.7.m.l.8.7.m.l.8.7.m.l.8.7.m.l.3.
................D.......D.............
k.k.k.k.i.i.k.k.L.i.k.k.i.i.k.k.K.l.3.
y.0...................................
j.j.j.j.j.j.j.j.j.j.j.j.j.j.j.j.j.p.3.
......................................
1.1.1.1.1.1.1.1.1.1.1.1.1.1.1.1.1.1.b.
......................................
