2.2.2.2.2.2.2.2.2.9...s....t..s.a.2.2.2.2.2.2.2.2.2.2.9.
....................t...................................
k.k.k.k.k.kAk.k.n.3...a.2.2.2.2.7.o.k.k.k.k.kAk.k.k.n.3.
y.0.....................................................
j.j.j.j.j.j.j.i.l.3..t4.o.k.k.kAk.i.i.j.j.j.j.j.j.i.l.3.
........................................................
1.1.1.u.h.h.f.m.l.3...4.m.i.j.j.j.j.p.6.u.h.h.h.f.m.l.3.
....................s...................................
...r..4.o.k.kBi.l.3...4.m.l.6.u.h.h.h.e.4.o.k.k.k.i.l.3.
.G......................................................
....s.4.m.i.j.j.p.3.t.4.m.l.3.4.o.k.n.3.4.m.i.j.j.j.p.3.
t.......................C.......z.......................
......4.m.l.g.h.h.x.2.7.m.l.3.4.q.i.l.8.7.m.l.6.1.1.1.b.
........................................................
....s.4.m.i.k.k.k.kAk.k.i.l.3.c.5.m.i.kBk.i.l.3.r.....s.
t.................................................t.....
...t..4.q.j.j.j.j.j.j.j.j.p.3t..4.q.j.j.j.j.p.3.........
.s.................................................t....
....t.c.1.1.1.1.1.1.1.1.1.1.b.r.c.1.1.1.1.1.1.b..r....t.
........................................................
