2.2.2.2.2.2.2.9.s.t.a.2.2.2.2.H.2.2.2.2.2.H.H.2.2.2.2.9.
........................................................
k.k.k.k.k.k.n.3.....4.o.k.k.k.i.k.kBk.kBk.i.i.k.k.k.n.3.
y.0.............G......z................................
j.j.j.j.j.i.l.3.....4.q.j.j.j.j.j.j.j.j.j.j.j.j.j.i.l.3.
................s.......................................
u.h.h.h.f.m.l.3.....d.h.h.h.h.h.h.h.v.1.1.1.1.1.5.m.l.3.
..........D.......................................C.....
4.o.k.k.k.i.l.3..t..4.o.k.k.kAk.k.n.3.r.t..s....4.m.l.3.
..............................................t.........
4.m.i.j.j.j.p.3.t...4.m.i.j.j.j.i.l.3..t....t...4.m.l.3.
..................................................C.....
4.m.l.g.h.h.h.x.H.H.7.m.l.6.1.5.m.l.8.2.2.2.H.H.7.m.l.3.
..D...................C.................................
4.m.i.k.k.kAk.k.i.i.k.i.l.3.t.4.m.i.k.kAk.k.i.i.k.i.l.3.
........................................................
4.q.j.j.j.j.j.j.j.j.j.j.p.3...4.q.j.j.j.j.j.j.j.j.j.p.3.
............................r...........................
c.1.1.1.1.1.1.1.1.1.1.1.1.b...c.1.1.1.1.1.1.1.1.1.1.1.b.
........................................................
