....s.t.a.2.2.2.2.2.2.2.2.2.2.2.2.2.2.2.2.2.2.2.2.2.2.9.
........................................................
2.2.2.2.7.o.k.k.kAk.k.k.kAk.kAk.k.kAk.kAk.k.k.kAk.k.n.3.
........................................................
k.k.k.k.k.i.i.j.j.j.I.i.j.j.j.i.i.j.j.j.i.L.j.j.j.i.l.3.
y.0.....................................................
j.j.j.j.j.i.l.g.h.f.m.l.g.h.f.m.l.g.h.f.m.l.g.h.f.m.l.3.
........................................................
1.1.1.1.5.m.i.kAk.kAi.J.k.kAk.i.K.k.kAk.i.i.kAk.kAi.l.3.
........................................................
.r....r.4.q.j.j.j.j.j.j.j.j.j.j.j.j.j.j.j.j.j.j.j.i.l.3.
.E......................................................
........d.h.h.h.h.h.h.h.h.h.h.h.h.h.h.h.h.h.h.h.f.m.l.3.
..................................................M.....
.....s..4.o.k.k.kBk.kBk.kBk.kBk.kBk.kBk.kBk.kBk.k.i.l.3.
...........z............................................
..G.....4.q.j.j.j.j.j.j.j.j.j.j.j.j.j.j.j.j.j.j.j.j.p.3.
........................................................
r.....t.c.1.1.1.1.1.1.1.1.1.1.1.1.1.1.1.1.1.1.1.1.1.1.b.
........................................................
