t...s.t.a.2.2.2.2.2.2.2.2.2.2.2.2.2.2.9.s.....
..........................................t...
2.2.2.2.7.o.k.k.k.k.k.k.k.k.k.k.k.k.n.3.......
.........................................t....
k.k.k.k.k.i.i.j.j.i.i.j.j.i.K.j.j.L.l.3....t..
y.0.....................................s.....
j.j.j.j.j.i.l.6.5.m.l.6.5.m.l.6.5.m.l.3....s..
..............................................
1.1.1.1.5.m.l.3.4.m.l.3.4.m.l.3.4.m.l.3..t....
............................................t.
......r.4.m.l.3.4.m.l.3.4.m.l.3.4.m.l.3.t.s...
.E............................................
........4.m.l.8.7.m.l.8.7.m.l.8.7.m.l.8.2.2.9.
..............................................
........4.m.I.k.k.i.i.k.k.J.i.k.k.i.i.kMk.n.3.
.........................................z....
..G....t4.q.j.j.j.j.j.j.j.j.j.j.j.j.j.j.j.p.3.
..............................................
r.....t.c.1.1.1.1.1.1.1.1.1.1.1.1.1.1.1.1.1.b.
..............................................
